//MAP CONVERTED BY dmm2tgm.py THIS HEADER COMMENT PREVENTS RECONVERSION, DO NOT REMOVE
"aa" = (
/turf/closed/indestructible/riveted,
/area/mafia)
"ab" = (
/turf/closed/indestructible/reinforced,
/area/centcom/mafia)
"ac" = (
/turf/closed/wall/rust,
/area/mafia)
"ad" = (
/turf/open/floor/plating,
/area/mafia)
"ae" = (
/turf/open/floor/plating{
	icon_state = "platingdmg3"
	},
/area/mafia)
"af" = (
/turf/open/floor/plating{
	icon_state = "panelscorched"
	},
/area/mafia)
"ag" = (
/obj/mafia_game_board,
/turf/open/floor/plating{
	icon_state = "platingdmg3"
	},
/area/mafia)
"ah" = (
/obj/structure/grille/indestructable,
/turf/open/floor/plating,
/area/mafia)
"ai" = (
/turf/open/floor/plating{
	icon_state = "platingdmg1"
	},
/area/mafia)
"aj" = (
/obj/machinery/door/airlock/external/ruin{
	max_integrity = 99999;
	name = "Maintenance"
	},
/obj/effect/mapping_helpers/airlock/locked,
/turf/open/floor/plating,
/area/mafia)
"ak" = (
/obj/mafia_game_board,
/turf/open/floor/plating,
/area/mafia)
"al" = (
/obj/structure/closet{
	desc = "It's a storage unit. For mining stuff. Y'know.";
	icon_state = "mining";
	name = "miner equipment locker"
	},
/obj/item/clothing/under/rank/cargo/miner/lavaland,
/turf/open/floor/grass/fakebasalt,
/area/mafia)
"am" = (
/obj/effect/landmark/mafia,
/turf/open/floor/grass/fakebasalt,
/area/mafia)
"an" = (
/obj/effect/landmark/mafia,
/obj/effect/turf_decal/trimline/brown/filled/line{
	dir = 9
	},
/obj/effect/turf_decal/trimline/brown/filled/corner,
/turf/open/floor/iron,
/area/mafia)
"ao" = (
/obj/effect/turf_decal/trimline/brown/filled/end{
	dir = 4
	},
/obj/structure/closet{
	desc = "It's a storage unit. For mining stuff. Y'know.";
	icon_state = "mining";
	name = "miner equipment locker"
	},
/obj/item/clothing/under/rank/cargo/miner/lavaland,
/turf/open/floor/iron,
/area/mafia)
"ap" = (
/obj/machinery/door/poddoor/preopen{
	desc = "When it's time to sleep, the lights will go out. Remember - no one in space can hear you scream.";
	id = "mafia";
	max_integrity = 99999;
	name = "Station Night Shutters"
	},
/turf/closed/indestructible/fakeglass,
/area/mafia)
"aq" = (
/turf/open/floor/grass/fakebasalt,
/area/mafia)
"ar" = (
/obj/effect/turf_decal/trimline/brown/filled/line{
	dir = 9
	},
/obj/structure/closet{
	desc = "It's a storage unit. For mining stuff. Y'know.";
	icon_state = "mining";
	name = "miner equipment locker"
	},
/obj/item/clothing/under/rank/cargo/miner/lavaland,
/turf/open/floor/iron,
/area/mafia)
"as" = (
/obj/effect/turf_decal/trimline/brown/filled/line{
	dir = 9
	},
/turf/open/floor/iron,
/area/mafia)
"at" = (
/obj/effect/turf_decal/tile/red,
/obj/effect/turf_decal/tile/red{
	dir = 8
	},
/turf/open/floor/iron/dark,
/area/mafia)
"au" = (
/obj/effect/turf_decal/tile/red{
	dir = 4
	},
/obj/effect/turf_decal/tile/red,
/turf/open/floor/iron/dark,
/area/mafia)
"av" = (
/obj/mafia_game_board,
/turf/open/floor/plating{
	icon_state = "panelscorched"
	},
/area/mafia)
"aw" = (
/obj/effect/turf_decal/trimline/brown/filled/line{
	dir = 1
	},
/obj/effect/turf_decal/trimline/brown/filled/corner,
/turf/open/floor/iron,
/area/mafia)
"ax" = (
/obj/effect/turf_decal/trimline/brown/filled/line{
	dir = 1
	},
/obj/effect/turf_decal/trimline/brown/filled/line,
/turf/open/floor/iron,
/area/mafia)
"ay" = (
/obj/effect/turf_decal/trimline/brown/filled/end{
	dir = 4
	},
/turf/open/floor/iron,
/area/mafia)
"az" = (
/obj/effect/turf_decal/trimline/brown/filled/line{
	dir = 5
	},
/obj/structure/closet{
	desc = "It's a storage unit. For mining stuff. Y'know.";
	icon_state = "mining";
	name = "miner equipment locker"
	},
/obj/item/clothing/under/rank/cargo/miner/lavaland,
/turf/open/floor/iron,
/area/mafia)
"aA" = (
/obj/effect/landmark/mafia,
/obj/effect/turf_decal/trimline/brown/filled/line{
	dir = 6
	},
/turf/open/floor/iron,
/area/mafia)
"aB" = (
/obj/effect/turf_decal/trimline/brown/filled/end{
	dir = 1
	},
/turf/open/floor/iron,
/area/mafia)
"aC" = (
/obj/effect/turf_decal/trimline/brown/filled/line{
	dir = 4
	},
/obj/effect/turf_decal/trimline/brown/filled/line{
	dir = 8
	},
/turf/open/floor/iron,
/area/mafia)
"aD" = (
/obj/effect/turf_decal/trimline/brown/filled/line{
	dir = 10
	},
/obj/effect/turf_decal/trimline/brown/filled/corner{
	dir = 4
	},
/turf/open/floor/iron,
/area/mafia)
"aE" = (
/obj/effect/turf_decal/trimline/brown/filled/line{
	dir = 1
	},
/obj/effect/turf_decal/trimline/brown/filled/corner{
	dir = 8
	},
/turf/open/floor/iron,
/area/mafia)
"aF" = (
/obj/effect/turf_decal/trimline/brown/filled/line{
	dir = 5
	},
/turf/open/floor/iron,
/area/mafia)
"aG" = (
/obj/effect/landmark/mafia,
/obj/effect/turf_decal/trimline/brown/filled/line{
	dir = 10
	},
/turf/open/floor/iron,
/area/mafia)
"aH" = (
/obj/effect/turf_decal/trimline/brown/filled/line{
	dir = 10
	},
/obj/structure/closet{
	desc = "It's a storage unit. For mining stuff. Y'know.";
	icon_state = "mining";
	name = "miner equipment locker"
	},
/obj/item/clothing/under/rank/cargo/miner/lavaland,
/turf/open/floor/iron,
/area/mafia)
"aI" = (
/obj/effect/turf_decal/trimline/brown/filled/line{
	dir = 6
	},
/obj/structure/closet{
	desc = "It's a storage unit. For mining stuff. Y'know.";
	icon_state = "mining";
	name = "miner equipment locker"
	},
/obj/item/clothing/under/rank/cargo/miner/lavaland,
/turf/open/floor/iron,
/area/mafia)
"aJ" = (
/obj/effect/landmark/mafia,
/obj/effect/turf_decal/trimline/brown/filled/line{
	dir = 6
	},
/obj/effect/turf_decal/trimline/brown/filled/corner{
	dir = 1
	},
/turf/open/floor/iron,
/area/mafia)
"aK" = (
/obj/effect/turf_decal/trimline/brown/filled/end{
	dir = 8
	},
/obj/structure/closet{
	desc = "It's a storage unit. For mining stuff. Y'know.";
	icon_state = "mining";
	name = "miner equipment locker"
	},
/obj/item/clothing/under/rank/cargo/miner/lavaland,
/turf/open/floor/iron,
/area/mafia)
"aL" = (
/obj/effect/landmark/mafia,
/obj/effect/turf_decal/trimline/brown/filled/line{
	dir = 5
	},
/turf/open/floor/iron,
/area/mafia)
"aM" = (
/obj/effect/turf_decal/trimline/brown/filled/line{
	dir = 10
	},
/turf/open/floor/iron,
/area/mafia)
"aN" = (
/obj/effect/turf_decal/trimline/brown/filled/line,
/obj/effect/turf_decal/trimline/brown/filled/corner{
	dir = 4
	},
/turf/open/floor/iron,
/area/mafia)
"aO" = (
/obj/effect/turf_decal/trimline/brown/filled/corner{
	dir = 8
	},
/obj/effect/turf_decal/trimline/brown/filled/line{
	dir = 5
	},
/turf/open/floor/iron,
/area/mafia)
"aP" = (
/obj/effect/turf_decal/trimline/brown/filled/end,
/turf/open/floor/iron,
/area/mafia)
"aQ" = (
/obj/effect/landmark/mafia,
/obj/effect/turf_decal/trimline/brown/filled/line{
	dir = 9
	},
/turf/open/floor/iron,
/area/mafia)
"aR" = (
/obj/effect/baseturf_helper/asteroid,
/obj/effect/landmark/mafia/town_center,
/obj/effect/turf_decal/tile/red,
/obj/effect/turf_decal/tile/red{
	dir = 1
	},
/obj/effect/turf_decal/tile/red{
	dir = 8
	},
/obj/effect/turf_decal/tile/red{
	dir = 4
	},
/turf/open/floor/iron/dark,
/area/mafia)
"aS" = (
/obj/effect/turf_decal/trimline/brown/filled/end{
	dir = 8
	},
/turf/open/floor/iron,
/area/mafia)
"aT" = (
/obj/effect/turf_decal/trimline/brown/filled/line,
/obj/effect/turf_decal/trimline/brown/filled/line{
	dir = 1
	},
/turf/open/floor/iron,
/area/mafia)
"aU" = (
/obj/effect/turf_decal/trimline/brown/filled/line,
/obj/effect/turf_decal/trimline/brown/filled/corner{
	dir = 1
	},
/turf/open/floor/iron,
/area/mafia)
"aV" = (
/obj/effect/turf_decal/trimline/brown/filled/line{
	dir = 6
	},
/turf/open/floor/iron,
/area/mafia)
"aW" = (
/obj/effect/turf_decal/tile/red{
	dir = 8
	},
/obj/effect/turf_decal/tile/red{
	dir = 1
	},
/turf/open/floor/iron/dark,
/area/mafia)
"aX" = (
/obj/effect/turf_decal/tile/red{
	dir = 1
	},
/obj/effect/turf_decal/tile/red{
	dir = 4
	},
/turf/open/floor/iron/dark,
/area/mafia)
"aY" = (
/turf/closed/indestructible/reinforced,
/area/mafia)
"aZ" = (
/turf/closed/indestructible/riveted,
/area/centcom/mafia)
"bo" = (
/obj/effect/turf_decal/trimline/brown/filled/end{
	dir = 4
	},
/turf/open/floor/iron,
/area/centcom/mafia)
"bD" = (
/obj/effect/turf_decal/trimline/brown/filled/end{
	dir = 1
	},
/turf/open/floor/iron,
/area/centcom/mafia)
"bG" = (
/obj/effect/baseturf_helper/asteroid,
/obj/effect/landmark/mafia/town_center,
/obj/effect/turf_decal/tile/red/fourcorners,
/turf/open/floor/iron/dark,
/area/centcom/mafia)
"dW" = (
/obj/effect/turf_decal/trimline/brown/filled/end{
	dir = 8
	},
/turf/open/floor/iron,
/area/centcom/mafia)
"ee" = (
/obj/effect/turf_decal/trimline/brown/filled/line{
	dir = 6
	},
/turf/open/floor/iron,
/area/centcom/mafia)
"ey" = (
/obj/effect/landmark/mafia,
/obj/effect/turf_decal/trimline/brown/filled/line{
	dir = 6
	},
/turf/open/floor/iron,
/area/centcom/mafia)
"ez" = (
/obj/effect/turf_decal/trimline/brown/filled/line{
	dir = 1
	},
/obj/effect/turf_decal/trimline/brown/filled/corner{
	dir = 8
	},
/turf/open/floor/iron,
/area/centcom/mafia)
"eQ" = (
/obj/effect/landmark/mafia,
/obj/effect/turf_decal/trimline/brown/filled/line{
	dir = 6
	},
/obj/effect/turf_decal/trimline/brown/filled/corner{
	dir = 1
	},
/turf/open/floor/iron,
/area/centcom/mafia)
"fX" = (
/turf/closed/wall/rust,
/area/centcom/mafia)
"gs" = (
/turf/open/floor/plating,
/area/centcom/mafia)
"iE" = (
/obj/effect/landmark/mafia,
/obj/effect/turf_decal/trimline/brown/filled/line{
	dir = 5
	},
/turf/open/floor/iron,
/area/centcom/mafia)
"jk" = (
/obj/mafia_game_board,
/obj/effect/mapping_helpers/broken_floor,
/turf/open/floor/plating,
/area/centcom/mafia)
"kZ" = (
/obj/effect/turf_decal/trimline/brown/filled/line,
/obj/effect/turf_decal/trimline/brown/filled/line{
	dir = 1
	},
/turf/open/floor/iron,
/area/centcom/mafia)
"lc" = (
/obj/effect/turf_decal/trimline/brown/filled/line{
	dir = 1
	},
/obj/effect/turf_decal/trimline/brown/filled/corner,
/turf/open/floor/iron,
/area/centcom/mafia)
"nW" = (
/obj/effect/turf_decal/tile/red{
	dir = 4
	},
/obj/effect/turf_decal/tile/red,
/turf/open/floor/iron/dark,
/area/centcom/mafia)
"oa" = (
/obj/effect/turf_decal/tile/red{
	dir = 8
	},
/obj/effect/turf_decal/tile/red{
	dir = 1
	},
/turf/open/floor/iron/dark,
/area/centcom/mafia)
"oP" = (
/obj/effect/turf_decal/trimline/brown/filled/line{
	dir = 9
	},
/obj/structure/closet{
	desc = "It's a storage unit. For mining stuff. Y'know.";
	icon_state = "mining";
	name = "miner equipment locker"
	},
/obj/item/clothing/under/rank/cargo/miner/lavaland,
/turf/open/floor/iron,
/area/centcom/mafia)
"ph" = (
/obj/effect/turf_decal/trimline/brown/filled/line{
	dir = 5
	},
/obj/structure/closet{
	desc = "It's a storage unit. For mining stuff. Y'know.";
	icon_state = "mining";
	name = "miner equipment locker"
	},
/obj/item/clothing/under/rank/cargo/miner/lavaland,
/turf/open/floor/iron,
/area/centcom/mafia)
"pM" = (
/obj/effect/turf_decal/trimline/brown/filled/line,
/obj/effect/turf_decal/trimline/brown/filled/corner{
	dir = 1
	},
/turf/open/floor/iron,
/area/centcom/mafia)
"sz" = (
/obj/effect/turf_decal/trimline/brown/filled/line,
/obj/effect/turf_decal/trimline/brown/filled/corner{
	dir = 4
	},
/turf/open/floor/iron,
/area/centcom/mafia)
"uD" = (
/obj/effect/turf_decal/trimline/brown/filled/end{
	dir = 4
	},
/obj/structure/closet{
	desc = "It's a storage unit. For mining stuff. Y'know.";
	icon_state = "mining";
	name = "miner equipment locker"
	},
/obj/item/clothing/under/rank/cargo/miner/lavaland,
/turf/open/floor/iron,
/area/centcom/mafia)
"vr" = (
/obj/structure/grille/indestructable,
/turf/open/floor/plating,
/area/centcom/mafia)
"zn" = (
/obj/machinery/door/airlock/external/ruin{
	max_integrity = 99999;
	name = "Maintenance"
	},
/obj/effect/mapping_helpers/airlock/locked,
/turf/open/floor/plating,
/area/centcom/mafia)
"zU" = (
/obj/mafia_game_board,
/turf/open/floor/plating,
/area/centcom/mafia)
"Ar" = (
/turf/open/floor/fakebasalt,
/area/centcom/mafia)
"BH" = (
/obj/effect/turf_decal/trimline/brown/filled/line{
	dir = 1
	},
/obj/effect/turf_decal/trimline/brown/filled/line,
/turf/open/floor/iron,
/area/centcom/mafia)
"Cc" = (
/obj/effect/turf_decal/trimline/brown/filled/line{
	dir = 6
	},
/obj/structure/closet{
	desc = "It's a storage unit. For mining stuff. Y'know.";
	icon_state = "mining";
	name = "miner equipment locker"
	},
/obj/item/clothing/under/rank/cargo/miner/lavaland,
/turf/open/floor/iron,
/area/centcom/mafia)
"Cn" = (
/obj/effect/turf_decal/trimline/brown/filled/line{
	dir = 9
	},
/turf/open/floor/iron,
/area/centcom/mafia)
"Ej" = (
/obj/effect/landmark/mafia,
/obj/effect/turf_decal/trimline/brown/filled/line{
	dir = 9
	},
/turf/open/floor/iron,
/area/centcom/mafia)
"Em" = (
/obj/effect/turf_decal/tile/red,
/obj/effect/turf_decal/tile/red{
	dir = 8
	},
/turf/open/floor/iron/dark,
/area/centcom/mafia)
"Ep" = (
/obj/effect/turf_decal/trimline/brown/filled/end,
/turf/open/floor/iron,
/area/centcom/mafia)
"EN" = (
/obj/effect/landmark/mafia,
/obj/effect/turf_decal/trimline/brown/filled/line{
	dir = 10
	},
/turf/open/floor/iron,
/area/centcom/mafia)
"HF" = (
/obj/effect/turf_decal/trimline/brown/filled/line{
	dir = 10
	},
/obj/effect/turf_decal/trimline/brown/filled/corner{
	dir = 4
	},
/turf/open/floor/iron,
/area/centcom/mafia)
"IZ" = (
/obj/effect/mapping_helpers/broken_floor,
/turf/open/floor/plating,
/area/centcom/mafia)
"KJ" = (
/obj/effect/turf_decal/trimline/brown/filled/line{
	dir = 4
	},
/obj/effect/turf_decal/trimline/brown/filled/line{
	dir = 8
	},
/turf/open/floor/iron,
/area/centcom/mafia)
"LD" = (
/obj/effect/turf_decal/trimline/brown/filled/end{
	dir = 8
	},
/obj/structure/closet{
	desc = "It's a storage unit. For mining stuff. Y'know.";
	icon_state = "mining";
	name = "miner equipment locker"
	},
/obj/item/clothing/under/rank/cargo/miner/lavaland,
/turf/open/floor/iron,
/area/centcom/mafia)
"MS" = (
/obj/effect/mapping_helpers/burnt_floor,
/turf/open/floor/plating,
/area/centcom/mafia)
"Nn" = (
/obj/effect/turf_decal/trimline/brown/filled/line{
	dir = 10
	},
/turf/open/floor/iron,
/area/centcom/mafia)
"OK" = (
/obj/effect/landmark/mafia,
/obj/effect/turf_decal/trimline/brown/filled/line{
	dir = 9
	},
/obj/effect/turf_decal/trimline/brown/filled/corner,
/turf/open/floor/iron,
/area/centcom/mafia)
"Pa" = (
/obj/effect/turf_decal/trimline/brown/filled/line{
	dir = 10
	},
/obj/structure/closet{
	desc = "It's a storage unit. For mining stuff. Y'know.";
	icon_state = "mining";
	name = "miner equipment locker"
	},
/obj/item/clothing/under/rank/cargo/miner/lavaland,
/turf/open/floor/iron,
/area/centcom/mafia)
"Tk" = (
/obj/mafia_game_board,
/obj/effect/mapping_helpers/burnt_floor,
/turf/open/floor/plating,
/area/centcom/mafia)
"UN" = (
/obj/machinery/door/poddoor/preopen{
	desc = "When it's time to sleep, the lights will go out. Remember - no one in space can hear you scream.";
	id = "mafia";
	max_integrity = 99999;
	name = "Station Night Shutters"
	},
/turf/closed/indestructible/fakeglass,
/area/centcom/mafia)
"VZ" = (
/obj/effect/turf_decal/tile/red{
	dir = 1
	},
/obj/effect/turf_decal/tile/red{
	dir = 4
	},
/turf/open/floor/iron/dark,
/area/centcom/mafia)
"Ws" = (
/obj/effect/turf_decal/trimline/brown/filled/corner{
	dir = 8
	},
/obj/effect/turf_decal/trimline/brown/filled/line{
	dir = 5
	},
/turf/open/floor/iron,
/area/centcom/mafia)
"Xh" = (
/obj/effect/turf_decal/trimline/brown/filled/line{
	dir = 5
	},
/turf/open/floor/iron,
/area/centcom/mafia)
"Xj" = (
/obj/structure/closet{
	desc = "It's a storage unit. For mining stuff. Y'know.";
	icon_state = "mining";
	name = "miner equipment locker"
	},
/obj/item/clothing/under/rank/cargo/miner/lavaland,
/turf/open/floor/fakebasalt,
/area/centcom/mafia)
"Xn" = (
/obj/effect/landmark/mafia,
/turf/open/floor/fakebasalt,
/area/centcom/mafia)

(1,1,1) = {"
aZ
aZ
aZ
aZ
aZ
aZ
aZ
aZ
aZ
aZ
aZ
aZ
aZ
aZ
aZ
aZ
aZ
aZ
aZ
aZ
aZ
aZ
aZ
"}
(2,1,1) = {"
aZ
ab
ab
ab
ab
ab
ab
ab
ab
ab
ab
ab
ab
ab
ab
ab
ab
ab
ab
ab
ab
ab
aZ
"}
(3,1,1) = {"
aZ
ab
ab
fX
fX
fX
fX
fX
fX
fX
fX
fX
fX
fX
fX
fX
fX
fX
fX
fX
ab
ab
aZ
"}
(4,1,1) = {"
aZ
ab
ab
fX
jk
vr
gs
gs
gs
gs
gs
IZ
gs
gs
gs
gs
gs
vr
zU
fX
ab
ab
aZ
"}
(5,1,1) = {"
aZ
ab
ab
fX
vr
gs
gs
IZ
ab
ab
zn
ab
zn
ab
ab
gs
gs
IZ
vr
fX
ab
ab
aZ
"}
(6,1,1) = {"
aZ
ab
ab
fX
IZ
ab
ab
zn
ab
Xj
Ar
ab
Cn
Pa
ab
zn
ab
ab
gs
fX
ab
ab
aZ
"}
(7,1,1) = {"
aZ
ab
fX
fX
gs
ab
oP
Nn
UN
Xn
Ar
UN
lc
ey
UN
Ar
Xj
ab
gs
fX
fX
ab
aZ
"}
(8,1,1) = {"
aZ
ab
fX
gs
gs
ab
iE
sz
ab
ab
Ar
ab
BH
ab
ab
Ar
Xn
ab
gs
gs
fX
ab
aZ
"}
(9,1,1) = {"
aZ
ab
fX
gs
ab
ab
UN
Ws
Ep
UN
Ar
UN
bo
UN
Ar
Ar
UN
ab
ab
gs
fX
ab
aZ
"}
(10,1,1) = {"
aZ
ab
fX
gs
ab
Xj
UN
ab
UN
UN
UN
UN
UN
UN
UN
ab
UN
LD
ab
gs
fX
ab
aZ
"}
(11,1,1) = {"
aZ
ab
fX
gs
zn
Xn
Ar
Ar
Ar
UN
Ar
nW
Ar
UN
bD
KJ
KJ
eQ
zn
IZ
fX
ab
aZ
"}
(12,1,1) = {"
aZ
ab
fX
IZ
ab
ab
UN
ab
UN
UN
Em
bG
VZ
UN
UN
ab
UN
ab
ab
gs
fX
ab
aZ
"}
(13,1,1) = {"
aZ
ab
fX
gs
zn
OK
KJ
KJ
Ep
UN
Ar
oa
Ar
UN
Ar
Ar
Ar
Xn
zn
gs
fX
ab
aZ
"}
(14,1,1) = {"
aZ
ab
fX
gs
ab
uD
UN
ab
UN
UN
UN
UN
UN
UN
UN
ab
UN
Xj
ab
IZ
fX
ab
aZ
"}
(15,1,1) = {"
aZ
ab
fX
gs
ab
ab
UN
Ar
Ar
UN
dW
UN
Ar
UN
bD
HF
UN
ab
ab
gs
fX
ab
aZ
"}
(16,1,1) = {"
aZ
ab
fX
MS
gs
ab
Xn
Ar
ab
ab
kZ
ab
Ar
ab
ab
ez
EN
ab
gs
gs
fX
ab
aZ
"}
(17,1,1) = {"
aZ
ab
fX
fX
gs
ab
Xj
Ar
UN
Ej
pM
UN
Ar
Xn
UN
Xh
Cc
ab
gs
fX
fX
ab
aZ
"}
(18,1,1) = {"
aZ
ab
ab
fX
gs
ab
ab
zn
ab
ph
ee
ab
Ar
Xj
ab
zn
ab
ab
gs
fX
ab
ab
aZ
"}
(19,1,1) = {"
aZ
ab
ab
fX
vr
IZ
gs
gs
ab
ab
zn
ab
zn
ab
ab
gs
IZ
gs
vr
fX
ab
ab
aZ
"}
(20,1,1) = {"
aZ
ab
ab
fX
zU
vr
gs
gs
IZ
gs
gs
gs
gs
gs
gs
gs
gs
vr
Tk
fX
ab
ab
aZ
"}
(21,1,1) = {"
aZ
ab
ab
fX
fX
fX
fX
fX
fX
fX
fX
fX
fX
fX
fX
fX
fX
fX
fX
fX
ab
ab
aZ
"}
(22,1,1) = {"
aZ
ab
ab
ab
ab
ab
ab
ab
ab
ab
ab
ab
ab
ab
ab
ab
ab
ab
ab
ab
ab
ab
aZ
"}
(23,1,1) = {"
aZ
aZ
aZ
aZ
aZ
aZ
aZ
aZ
aZ
aZ
aZ
aZ
aZ
aZ
aZ
aZ
aZ
aZ
aZ
aZ
aZ
aZ
aZ
"}
