//MAP CONVERTED BY dmm2tgm.py THIS HEADER COMMENT PREVENTS RECONVERSION, DO NOT REMOVE
"aa" = (
/turf/template_noop,
/area/template_noop)
"ab" = (
/turf/closed/mineral/ash_rock,
/area/ruin/unpowered/no_grav)
"ac" = (
/obj/item/trash/sosjerky,
/turf/template_noop,
/area/template_noop)
"am" = (
/obj/structure/fluff/bus/passable/seat,
/obj/effect/decal/cleanable/dirt,
/turf/open/floor/iron/dark/airless{
	icon_state = "bus"
	},
/area/ruin/unpowered/no_grav)
"an" = (
/obj/structure/fluff/bus/passable/seat,
/obj/item/food/meatball,
/turf/open/floor/iron/dark/airless{
	icon_state = "bus"
	},
/area/ruin/unpowered/no_grav)
"ao" = (
/obj/effect/decal/cleanable/dirt,
/turf/open/floor/iron/dark/airless{
	icon_state = "bus"
	},
/area/ruin/unpowered/no_grav)
"ap" = (
/obj/structure/fluff/bus/passable/seat{
	pixel_y = 15
	},
/turf/open/floor/iron/dark/airless{
	icon_state = "bus"
	},
/area/ruin/unpowered/no_grav)
"aq" = (
/obj/structure/fluff/bus/passable/seat,
/obj/item/food/meatball,
/obj/effect/decal/cleanable/dirt,
/turf/open/floor/iron/dark/airless{
	icon_state = "bus"
	},
/area/ruin/unpowered/no_grav)
"ar" = (
/obj/structure/fluff/bus/passable/seat,
/obj/item/food/grown/cherry_bomb,
/turf/open/floor/iron/dark/airless{
	icon_state = "bus"
	},
/area/ruin/unpowered/no_grav)
"as" = (
/obj/structure/fluff/bus/passable/seat/driver,
/obj/effect/decal/cleanable/dirt,
/obj/item/food/grown/citrus/orange,
/turf/open/floor/iron/dark/airless{
	icon_state = "bus"
	},
/area/ruin/unpowered/no_grav)
"ax" = (
/obj/structure/fluff/bus/passable,
/obj/effect/decal/cleanable/dirt,
/turf/open/floor/iron/dark/airless{
	icon_state = "bus"
	},
/area/ruin/unpowered/no_grav)
"az" = (
/obj/structure/fluff/bus/passable,
/turf/open/floor/iron/dark/airless{
	icon_state = "bus"
	},
/area/ruin/unpowered/no_grav)
"aA" = (
/obj/structure/fluff/bus/passable,
/obj/structure/closet/crate/freezer,
/obj/item/food/meatball,
/obj/item/food/meatball,
/obj/item/food/meatball,
/turf/open/floor/iron/dark/airless{
	icon_state = "bus"
	},
/area/ruin/unpowered/no_grav)
"aB" = (
/obj/structure/fluff/bus/passable,
/obj/effect/mine/sound/bwoink,
/turf/open/floor/iron/dark/airless{
	icon_state = "bus"
	},
/area/ruin/unpowered/no_grav)
"aC" = (
/obj/structure/fluff/bus/passable,
/obj/item/reagent_containers/food/condiment/saltshaker,
/obj/effect/decal/cleanable/dirt,
/turf/open/floor/iron/dark/airless{
	icon_state = "bus"
	},
/area/ruin/unpowered/no_grav)
"aD" = (
/obj/structure/fluff/bus/passable,
/obj/item/food/meatball,
/turf/open/floor/iron/dark/airless{
	icon_state = "bus"
	},
/area/ruin/unpowered/no_grav)
"aE" = (
/obj/structure/fluff/bus/passable{
	icon_state = "topdoor"
	},
/obj/effect/decal/cleanable/dirt,
/turf/open/floor/iron/dark/airless{
	icon_state = "bus"
	},
/area/ruin/unpowered/no_grav)
"aU" = (
/obj/structure/fluff/bus/passable/seat,
/obj/effect/decal/cleanable/dirt,
/obj/item/food/meatball,
/turf/open/floor/iron/dark/airless{
	icon_state = "bus"
	},
/area/ruin/unpowered/no_grav)
"aV" = (
/obj/structure/fluff/bus/passable/seat,
/obj/effect/decal/remains/human,
/turf/open/floor/iron/dark/airless{
	icon_state = "bus"
	},
/area/ruin/unpowered/no_grav)
"aW" = (
/obj/structure/fluff/bus/passable/seat/driver,
/obj/effect/decal/cleanable/dirt,
/turf/open/floor/iron/dark/airless{
	icon_state = "bus"
	},
/area/ruin/unpowered/no_grav)
"aZ" = (
/obj/structure/fluff/bus/passable,
/obj/effect/decal/cleanable/dirt,
/obj/item/food/meatball,
/turf/open/floor/iron/dark/airless{
	icon_state = "bus"
	},
/area/ruin/unpowered/no_grav)
"ba" = (
/obj/structure/fluff/bus/passable,
/obj/item/banhammer,
/turf/open/floor/iron/dark/airless{
	icon_state = "bus"
	},
/area/ruin/unpowered/no_grav)
"bH" = (
/obj/effect/decal/cleanable/shreds,
/turf/open/misc/asteroid/airless,
/area/ruin/unpowered/no_grav)
"cv" = (
/obj/item/stack/sheet/iron/fifty,
/turf/open/misc/asteroid/airless,
/area/ruin/unpowered/no_grav)
"es" = (
/obj/effect/decal/cleanable/food/salt,
/obj/item/reagent_containers/food/condiment/saltshaker,
/turf/open/misc/asteroid/airless,
/area/ruin/unpowered/no_grav)
"eG" = (
/obj/structure/fluff/bus/dense{
	icon_state = "frontwallbottom"
	},
/turf/open/misc/asteroid/airless,
/area/ruin/unpowered/no_grav)
"kC" = (
/obj/item/reagent_containers/glass/rag,
/turf/open/misc/asteroid/airless,
/area/ruin/unpowered/no_grav)
"lX" = (
/obj/item/book/random,
/turf/open/misc/asteroid/airless,
/area/ruin/unpowered/no_grav)
"mt" = (
/obj/item/food/meatball,
/turf/open/misc/asteroid/airless,
/area/ruin/unpowered/no_grav)
"nk" = (
/mob/living/simple_animal/hostile/lizard,
/turf/open/misc/asteroid/airless,
/area/ruin/unpowered/no_grav)
"qx" = (
/obj/item/stack/cable_coil{
	amount = 5
	},
/obj/item/shard{
	icon_state = "small"
	},
/turf/open/misc/asteroid/airless,
/area/ruin/unpowered/no_grav)
"sB" = (
/obj/effect/decal/cleanable/oil,
/turf/open/misc/asteroid/airless,
/area/ruin/unpowered/no_grav)
"ti" = (
/obj/item/clothing/head/helmet/space,
/turf/open/misc/asteroid/airless,
/area/ruin/unpowered/no_grav)
"tk" = (
/obj/structure/table,
/obj/item/paicard,
/turf/open/misc/asteroid/airless,
/area/ruin/unpowered/no_grav)
"vk" = (
/obj/structure/reagent_dispensers/fueltank,
/turf/open/misc/asteroid/airless,
/area/ruin/unpowered/no_grav)
"vJ" = (
/obj/structure/fluff/bus/dense{
	icon_state = "frontwallbottomrear"
	},
/turf/open/misc/asteroid/airless,
/area/ruin/unpowered/no_grav)
"zk" = (
/obj/structure/fluff/bus/passable/seat,
/turf/open/misc/asteroid/airless,
/area/ruin/unpowered/no_grav)
"zQ" = (
/obj/item/stack/rods/fifty,
/obj/item/stock_parts/manipulator/femto,
/turf/open/misc/asteroid/airless,
/area/ruin/unpowered/no_grav)
"BR" = (
/obj/structure/fluff/bus/dense{
	icon_state = "reartire"
	},
/turf/open/misc/asteroid/airless,
/area/ruin/unpowered/no_grav)
"BS" = (
/obj/effect/decal/remains/human,
/obj/item/clothing/head/helmet/space,
/turf/open/misc/asteroid/airless,
/area/ruin/unpowered/no_grav)
"Dj" = (
/obj/structure/fluff/bus/dense{
	icon_state = "hoodtop"
	},
/turf/open/misc/asteroid/airless,
/area/ruin/unpowered/no_grav)
"DD" = (
/obj/structure/fluff/bus/dense{
	icon_state = "fronttire"
	},
/turf/open/misc/asteroid/airless,
/area/ruin/unpowered/no_grav)
"GZ" = (
/obj/effect/decal/remains/human,
/obj/item/clothing/suit/space,
/turf/open/misc/asteroid/airless,
/area/ruin/unpowered/no_grav)
"HC" = (
/obj/structure/fluff/bus/passable,
/obj/item/storage/medkit/regular,
/turf/open/floor/iron/dark/airless{
	icon_state = "bus"
	},
/area/ruin/unpowered/no_grav)
"IH" = (
/obj/structure/fluff/bus/dense,
/turf/open/misc/asteroid/airless,
/area/ruin/unpowered/no_grav)
"MS" = (
/turf/open/misc/asteroid/airless,
/area/ruin/unpowered/no_grav)
"Nh" = (
/obj/effect/decal/cleanable/robot_debris/old,
/turf/open/misc/asteroid/airless,
/area/ruin/unpowered/no_grav)
"NZ" = (
/obj/item/storage/toolbox/mechanical,
/obj/effect/decal/cleanable/oil,
/turf/open/misc/asteroid/airless,
/area/ruin/unpowered/no_grav)
"Pa" = (
/obj/item/clothing/head/cone,
/turf/open/misc/asteroid/airless,
/area/ruin/unpowered/no_grav)
"Qy" = (
/obj/structure/table,
/obj/item/reagent_containers/food/drinks/coffee,
/turf/open/misc/asteroid/airless,
/area/ruin/unpowered/no_grav)
"RG" = (
/obj/structure/closet/crate/grave,
/obj/item/clothing/head/collectable/swat,
/turf/open/misc/asteroid/airless,
/area/ruin/unpowered/no_grav)
"XA" = (
/obj/structure/fluff/bus/passable/seat,
/obj/effect/decal/cleanable/dirt,
/obj/item/toy/plush/awakenedplushie,
/turf/open/floor/iron/dark/airless{
	icon_state = "bus"
	},
/area/ruin/unpowered/no_grav)
"Yx" = (
/obj/structure/fluff/bus/dense{
	icon_state = "hoodbottom"
	},
/turf/open/misc/asteroid/airless,
/area/ruin/unpowered/no_grav)
"YZ" = (
/obj/structure/fluff/bus/dense{
	icon_state = "frontwallbottom"
	},
/obj/effect/decal/cleanable/oil,
/turf/open/misc/asteroid/airless,
/area/ruin/unpowered/no_grav)
"ZF" = (
/obj/structure/fluff/bus/passable{
	icon_state = "wheredahoodat"
	},
/turf/open/misc/asteroid/airless,
/area/ruin/unpowered/no_grav)
"ZQ" = (
/obj/structure/fluff/bus/passable{
	icon_state = "bottomdoor";
	layer = 3
	},
/turf/open/misc/asteroid/airless,
/area/ruin/unpowered/no_grav)

(1,1,1) = {"
aa
aa
aa
aa
aa
ab
ab
ab
MS
MS
MS
Pa
aa
MS
MS
MS
aa
aa
"}
(2,1,1) = {"
aa
aa
aa
aa
ab
ab
ab
ab
MS
MS
sB
MS
MS
MS
MS
MS
MS
aa
"}
(3,1,1) = {"
aa
aa
aa
ab
ab
ab
ab
ab
MS
sB
MS
mt
IH
aU
az
vJ
MS
MS
"}
(4,1,1) = {"
aa
aa
aa
ab
ab
ab
ab
MS
es
MS
MS
MS
IH
am
aZ
BR
MS
MS
"}
(5,1,1) = {"
aa
aa
ab
ab
ab
ab
MS
MS
MS
MS
sB
MS
IH
aV
ba
YZ
MS
MS
"}
(6,1,1) = {"
aa
aa
ab
ab
ab
RG
MS
IH
am
ax
vJ
MS
IH
aU
az
eG
MS
MS
"}
(7,1,1) = {"
aa
ab
ab
ab
ab
MS
MS
IH
an
HC
eG
MS
IH
aW
aE
ZQ
MS
MS
"}
(8,1,1) = {"
aa
ab
ab
ab
ab
nk
MS
IH
XA
az
BR
MS
ZF
Dj
Yx
DD
MS
MS
"}
(9,1,1) = {"
ab
ab
ab
ab
ab
ab
MS
IH
ao
aA
eG
kC
MS
bH
MS
MS
MS
aa
"}
(10,1,1) = {"
ab
ab
ab
ab
ab
ab
MS
IH
ap
aB
eG
MS
NZ
MS
MS
Pa
MS
aa
"}
(11,1,1) = {"
ab
ab
ab
ab
ab
ab
MS
IH
aq
aC
YZ
MS
MS
GZ
MS
MS
aa
aa
"}
(12,1,1) = {"
aa
ab
ab
ab
ab
vk
MS
IH
ar
ax
eG
MS
ti
MS
cv
MS
aa
aa
"}
(13,1,1) = {"
ab
ab
ab
ab
ab
zQ
MS
IH
am
aD
eG
MS
Nh
MS
MS
MS
aa
aa
"}
(14,1,1) = {"
ab
ab
ab
ab
ab
qx
MS
IH
as
aE
ZQ
MS
MS
mt
MS
aa
aa
aa
"}
(15,1,1) = {"
ab
ab
ab
ab
ab
ab
lX
ZF
Dj
Yx
DD
MS
MS
MS
MS
aa
aa
aa
"}
(16,1,1) = {"
aa
ab
ab
ab
ab
ab
ab
MS
Pa
MS
MS
Pa
MS
MS
MS
aa
aa
aa
"}
(17,1,1) = {"
aa
aa
ab
ab
ab
ab
ab
ab
MS
MS
Nh
MS
MS
MS
MS
aa
aa
aa
"}
(18,1,1) = {"
aa
aa
aa
ab
ab
ab
ab
ab
ab
MS
MS
MS
BS
MS
MS
aa
aa
aa
"}
(19,1,1) = {"
aa
aa
aa
aa
ab
ab
ab
ab
ab
ab
MS
MS
MS
MS
aa
aa
aa
aa
"}
(20,1,1) = {"
aa
aa
aa
aa
aa
ab
ab
ab
MS
zk
MS
MS
MS
MS
aa
aa
aa
aa
"}
(21,1,1) = {"
aa
ac
aa
aa
aa
aa
aa
MS
tk
Qy
MS
MS
aa
aa
aa
aa
aa
aa
"}
