//MAP CONVERTED BY dmm2tgm.py THIS HEADER COMMENT PREVENTS RECONVERSION, DO NOT REMOVE
"a" = (
/obj/machinery/light/small/red/directional{
	dir = 1
	},
/turf/open/floor/mineral/plastitanium,
/area/ruin/space/has_grav/powered/berry_physics)
"d" = (
/obj/structure/table/bronze,
/obj/item/seeds/berry{
	potency = 100
	},
/obj/item/seeds/berry/glow{
	potency = 100
	},
/obj/item/seeds/berry/glow{
	potency = 100
	},
/obj/item/seeds/berry/glow{
	potency = 100
	},
/obj/item/seeds/berry{
	potency = 100
	},
/obj/item/seeds/berry{
	potency = 100
	},
/obj/item/seeds/berry{
	potency = 100
	},
/turf/open/floor/mineral/plastitanium,
/area/ruin/space/has_grav/powered/berry_physics)
"h" = (
/obj/structure/table/bronze,
/obj/item/seeds/berry/glow{
	name = "Berrynger of Light";
	pixel_x = -10;
	pixel_y = 10;
	potency = 100
	},
/obj/item/seeds/berry/poison{
	name = "Berrynger of Poison";
	pixel_x = 10;
	pixel_y = 10;
	potency = 100
	},
/obj/item/seeds/berry/death{
	name = "Berrynger of Death";
	pixel_y = -10;
	potency = 100
	},
/obj/item/circuitboard/machine/protolathe{
	desc = "It looks covered in jam.";
	name = "Berry-Infused Protolathe (Machine Board)"
	},
/turf/open/floor/mineral/plastitanium,
/area/ruin/space/has_grav/powered/berry_physics)
"j" = (
/obj/item/gps/spaceruin,
/turf/open/floor/mineral/plastitanium/red,
/area/ruin/space/has_grav/powered/berry_physics)
"q" = (
/obj/machinery/door/airlock/external/glass,
/turf/open/floor/mineral/plastitanium,
/area/ruin/space/has_grav/powered/berry_physics)
"J" = (
/turf/open/floor/mineral/plastitanium,
/area/ruin/space/has_grav/powered/berry_physics)
"M" = (
/turf/closed/indestructible/riveted/uranium,
/area/ruin/space/has_grav/powered/berry_physics)
"O" = (
/obj/structure/table/bronze,
/obj/item/seeds/berry/death{
	potency = 100
	},
/obj/item/seeds/berry/death{
	potency = 100
	},
/obj/item/seeds/berry/death{
	potency = 100
	},
/obj/item/seeds/berry/poison{
	potency = 100
	},
/obj/item/seeds/berry/poison{
	potency = 100
	},
/obj/item/seeds/berry/poison{
	potency = 100
	},
/turf/open/floor/mineral/plastitanium,
/area/ruin/space/has_grav/powered/berry_physics)
"Q" = (
/turf/open/floor/mineral/plastitanium/red,
/area/ruin/space/has_grav/powered/berry_physics)
"S" = (
/turf/closed/wall/mineral/plastitanium/nodiagonal,
/area/ruin/space/has_grav/powered/berry_physics)
"X" = (
/turf/template_noop,
/area/template_noop)

(1,1,1) = {"
M
M
X
X
S
S
S
X
X
"}
(2,1,1) = {"
M
S
M
S
j
d
Q
S
X
"}
(3,1,1) = {"
X
M
S
S
a
Q
J
Q
S
"}
(4,1,1) = {"
X
X
S
h
Q
J
Q
J
q
"}
(5,1,1) = {"
X
M
S
S
a
Q
J
Q
S
"}
(6,1,1) = {"
M
S
M
S
Q
O
Q
S
X
"}
(7,1,1) = {"
M
M
X
X
S
S
S
X
X
"}
